##################################################
#......>.........................................#
#................................................#
#................................................#
#................................................#
#.....  .........................................#
#.....   ........................................#
#................................................#
#................................................#
#................................................#
#.......   .........  ...........................#
#.......   .......... ...........................#
#.......  ..........  ...........................#
#................................................#
#................................................#
#................................................#
#................................................#
#................................................#
#................................................#
##################################################
