##################################################
#......<...############..........................#
#..........############..#########################
#................................................#
###########################################......#
#................................................#
#...................####....############.........#
#...................####....############..######.#
#...................####....############..######.#
#.###############...####....############..######.#
#....##########.....####....############..######.#
#....##########.....####....############..######.#
#...................####....############..######.#
#....############...####....############..######.#
#...........................############..|......#
##############..g...........############..########
##############......######..############..########
##############..g...######..############..########
##############.................g.....g...........#
##################################################
